=login.html
LoginPage=login.html
login=LoginServlet
InvalidPage=invalid.html
searchLocation=SearchLocationServlet
updateProfile=UpdateProfileServlet
UpdateProfilePage=updateProfile.jsp
logout=LogoutServlet
ViewInfoPage=infor.jsp
NewfeedPage=newfeed.jsp
viewNewfeed=NewfeedServlet
viewEventDetail=ViewEventDetailServlet
EventDetailPage=eventDetail.jsp
locAndTimePage=loc_and_time.jsp
modifyLocation=ModifyLocationServlet
viewSlotAndTimeFree=ViewLocationAndTimeServlet
appendEventDetailPage=appendEventDetail.jsp
appendEventDetail=AppendEventDetailServlet
reviewEventPage=reviewEvent.jsp
reviewEvent=ReviewEventServlet
createEvent=CreateEventServlet
followEvent=FollowEventServlet
joinEvent=JoinEventServlet
handleMultipart=HandleMultipartServlet
comment=CommentServlet
reply=ReplyServlet
askQuestion=AskQuestionServlet
AdminPage=admin.jsp
manageByAdmin=ManageByAdminServlet
filterEventByAdmin=FilterEventByAdminServlet
manageUserByAdmin=ManageUserByAdminServlet